@@@@@@@
@P...@@
@.eee.@
@@.EEE@
@...@.@
@.....@
@@@@@@@