@@@@@@@
@P...@@
@.mf..@
@.@F.M@
@.....@
@@@@@@@