@@@@@@@
@..@@@@
@...@@@
@f.fP@@
@F.@f.@
@..F.F@
@@@@@@@