@@@@@@@
@..M.@@
@.@M.@@
@..M..@
@.mmm.@
@..@.P@
@@@@@@@