@@@@@@@@
@@....@@
@.MM...@
@.@.mme@
@...@PE@
@@@@@@@@
