@@@@@@@
@@@..@@
@P.Fm@@
@...f.@
@.@M..@
@.....@
@@@@@@@