@@@@@@@@
@....@@@
@...MM.@
@.mmfP.@
@..@.F.@
@@@@@@@@