@@@@@@
@P...@
@..mM@
@.Ff.@
@@@@@@
