@@@@@@@@
@..M..@@
@.mm@F.@
@.@Pf..@
@..M@..@
@@@@@@@@