@@@@@@@@@
@@p.....@
@.@.o...@
@.o.O...@
@.O.....@
@.......@
@@@@@@@@@