@@@@@@@@@
@@P.....@
@.@.m...@
@.m.M...@
@.M.....@
@.......@
@@@@@@@@@