......@@@@.....
......@MM@.....
...@@@@MM@@@@..
...@p.......@..
...@..d..mi.@..
...@.i....d.@..
...@.ff...o.@..
..@@..m...o.@..
@@@.........@@@
@.......ii..FF@
@.dmm.....d.FF@
@d...@@@@@@@@@@
@DDII@.........
@@@II@.........
@@@@@@.........
